11111111111111111111111111111111111111111111111111111111111111111111111111111111
1P001000100010001000100010001000100010001000100010001000100010001000100010001001
1010001000100010001000100010001000100010C010001000100010001000100010001000100011
10001000100010001000100010001000100010001000100010001000100010001000100010001001
1010001000100010001000100010001000100010C010001000100010001000100010001000100011
10001000100010001000100010001000100010001000100010001000100010001000100010001001
1010001000100010001000100010001000100010C010001000100010001000100010001000100011
10001000100010001000100010001000100010001000100010001000100010001000100010001001
1010001000100010001000100010001000100010C010001000100010001000100010001000100011
10001000100010001000100010001000100010001000100010001000100010001000100010001001
1010001000100010001000100010001000100010C010001000100010001000100010001000100011
10001000100010001000100010001000100010001000100010001000100010001000100010001001
1010001000100010001000100010001000100010C010001000100010001000100010001000100011
10001000100010001000100010001000100010001000100010001000100010001000100010001001
1010001000100010001000100010001000100010C010001000100010001000100010001000100011
10001000100010001000100010001000100010001000100010001000100010001000100010001001
1010001000100010001000100010001000100010C010001000100010001000100010001000100011
10001000100010001000100010001000100010001000100010001000100010001000100010001001
1010001000100010001000100010001000100010C010001000100010001000100010001000100011
10001000100010001000100010001000100010001000100010001000100010001000100010001001
1010001000100010001000100010001000100010C010001000100010001000100010001000100011
10001000100010001000100010001000100010001000100010001000100010001000100010001001
1010001000100010001000100010001000100010C0100010001000100010001000100010001000E1
11111111111111111111111111111111111111111111111111111111111111111111111111111111
