11111
1C1P1
10001
1E1R1
11111
