1111111111111111111111111111111111
1E000R0000R0000C00R00C000000000001
1010010100100000101001000000010101
10100100101R1010001001000000010101
1PR00000RC00C0R000000R000000000RC1
1111111111111111111111111111111111
