11111111111111111111111111111111111111111111111111111111111111111111111111111111111111111111111111111111111111111111
1P0000000000000000000000000000000000000000000000000000000000000000000000000000000000000000000000000000000000000000C1
10000000000000000000000000000000000000000000000000000000000000000000000000000000000000000000000000000000000000000001
10000000000000000000000000000000000000000000000000000000000000000000000000000000000000000000000000000000000000000001
10000000000000000000000000000000000000000000000000000000000000000000000000000000000000000000000000000000000000000001
10000000000000000000000000000000000000000000000000000000000000000000000000000000000000000000000000000000000000000001
10000000000000000000000000000000000000000000000000000000000000000000000000000000000000000000000000000000000000000001
10000000000000000000000000000000000000000000000000000000000000000000000000000000000000000000000000000000000000000001
1000000000000000000000000000000000000000000C1111111111111111111000C0001111111111111111110111111111111111111100000001
10000000000000000000000000000000000000000011111111111111111111C00000001111111111111111C00111111111111111111100000001
10000000000000000000000000000000000000001111111111111111111100000000001111111111111100000111111111111111111100000001
10000000000000000000000000000000000000111111111111111111110000000000001111111111110000000111111111111111111100000001
10000000000000000000000000000000000011111111111111111111000000000000001111111111100000000111111111111111111100000001
10000000000000000000000000000000001111111111111111111110000000000000001111111110000000000111111111111111111100000001
10000000000000000000000000000000111111111111111111111000000000000000001111111000000000000111111111111111111100000001
10000000000000000000000000000011111111111111111111100000000000000000001111100000000000000111111111111111111100000001
10000000000000000000000000000111111111111111111110000000000000000000001110000000000000000111111111111111111100000001
10000000000000000000000000011111111111111111111000000000000000000000001C0000000000000000C111111111111111111100000001
10000000000000000000000001111111111111111111100000000000000000000000000000000000000000001111111111111111111100000001
1000000000000000000000011111111111111111111000000000000000000000000000000000000000000011111111111111111111C000000001
10000000000000000000011111111111111111111000000000000000000000000000000000000000000011111111111111111111000000000001
10000000000000000001111111111111111111110000000000000000000000000000000000000000001111111111111111111100000000000001
10000000000000000111111111111111111111000000000000000000000000000000000000000000011111111111111111110000000000000001
10000000000000011111111111111111111100000000000000000000000000000000000000000001111111111111111111100000000000000001
10000000000000111111111111111111110000000000000000000000000000000000000000000111111111111111111110000000000000000001
10000000000011111111111111111111000000000000000000000000000000000000000000011111111111111111111000000000000000000001
100000000C1111111111111111111100000000000000000000000000000000000000000001111111111111111111100000000000000000000001
1000000011111111111111111111C000000000000000000000000000000000000000000C11111111111111111110000000000000000000000001
100000001111111111111111111111111111111111111111111111111111111100000001111111111111111111C00000000000000C1100000001
10000000111111111111111111111111111111111111111111111111111111110000000111111111111111111100000000000000111100000001
10000000111111111111111111111111111111111111111111111111111111110000000111111111111111111100000000000011111100000001
10000000111111111111111111111111111111111111111111111111111111110000000111111111111111111100000000000111111100000001
10000000111111111111111111111111111111111111111111111111111111110000000111111111111111111100000000011111111100000001
10000000111111111111111111111111111111111111111111111111111111110000000111111111111111111100000001111111111100000001
10000000111111111111111111111111111111111111111111111111111111110000000111111111111111111100000111111111111100000001
10000000111111111111111111111111111111111111111111111111111111110000000111111111111111111100011111111111111100000001
10000000000000000000000000000000000000000000C111111111111111111100000001111111111111111111C1111111111111111100000001
10000000000000000000000000000000000000000000011111111111111111110000000111111111111111111111111111111111111100000001
10000000000000000000000000000000000000000000011111111111111111110000000000000000000000000000000000000000000000000001
10000000000000000000000000000000000000000000011111111111111111110000000000000000000000000000000000000000000000000001
10000000000000000000000000000000000000000000011111111111111111110000000000000000000000000000000000000000000000000001
10000000000000000000000000000000000000000000011111111111111111110000000000000000000000000000000000000000000000000001
10000000000000000000000000000000000000000000011111111111111111110000000000000000000000000000000000000000000000000001
10000000000000000000000000000000000000000000011111111111111111110000000000000000000000000000000000000000000000000001
10000000000000000000000000000000000000000000011111111111111111110000000000000000000000000000000000000000000000000001
10000000000000000000000000000000000000000000011111111111111111110000000000000000000000000000000000000000000000000001
10000000000000000000000000000000000000000000000000000000000000000000000000000000000000000000000000000000000000000001
10000000000000000000000000000000000000000000000000000000000000000000000000000000000000000000000000000000000000000001
10000000000000000000000000000000000000000000000000000000000000000000000000000000000000000000000000000000000000000001
10000000000000000000000000000000000000000000000000000000000000000000000000000000000000000000000000000000000000000001
10000000000000000000000000000000000000000000000000000000000000000000000000000000000000000000000000000000000000000001
10000000000000000000000000000000000000000000000000000000000000000000000000000000000000000000000000000000000000000001
1C0000000000000000000000000000000000000000000000000000000000000000000000000000000000000000000000000000000000000000E1
11111111111111111111111111111111111111111111111111111111111111111111111111111111111111111111111111111111111111111111
