1111111111111111111111111111111111111111111111111111111111111111111111111111111111111111111111111111111111111111111111111
1E00000000000100100000100000000000100000000000000000100000100100000000000100000000000100000000100000000000000100000100001
1C00111111111100100111111111100111100111111100111111100111100111100111111100111111100100100100100100111100111100111111111
1000100000100000000100000100000000100100000100000000100000000100000100000100100000000000100100000100000100000000000100001
1100100111100100100111100100111100100111100111100100111100100111100100100111111111100100100111111100100100111100111111111
1000000000100100100100000000000100100100100000000100000100100000100000100000100100000100100000100100100100000100000100001
1000100111111111100111111100111111100100100111111100111111100111111100111111100111100100111100100100111111100100111111111
1000100100100000000100100000000100000100100000000100000000100000000000100000100100100100100000000100100000100100100100001
1000111100100111111100100111100100111100111111100100111100100111100111111100100100100111111111100100100111100100100100101
1000000100000000000000000100100100000000000100100100100000100000100100000000000100000100100000000100000100100100000100101
1000111100100100100100100100111111111111111100100111100100111100111100111100100111111100100111100100100100111100111111111
1000000000100100100100100100100100100000100000000100000100000000100100000100100100000000000000100100100100100000000100001
1000111111111100111111111100100100100111111111100111100111111100100100111111111111111100100100100111100100111100111100101
1000000000100000000100000000100000000000100000000100000100100100000100000100100000000000100100100000100100000000000100101
1111100111111111100111100100111100111100100100111111100100100100111111100100100100111111111111111111111111100111111111111
1000000000100000000000100100000100100100000100000000100100100100100100000100100100000000000000000100000000100000000000001
1011111111111111111100111111100111100100111111111111111100100111100111100100111111111111111111111111111100111100111111101
1000100100000100100000000000000000100000000100000100000000000000000100000000000000000000100000100100100000000000000100001
1011100100111100111100100111111100111100111111100111100100111100111100111100100111111100100100100100111111111111100100111
1000000100100000000100100100000100000000100000100000100100100100000100100100100100000100000100000100100100100000100100101
1100111100100111111111111111100111111111111100100111100111100100100100100111111111100100111100111100100100100100100100101
1000100100000000100000000000000100000000000000000000000000100100100000100000000000100000000100100000000100000100100100101
1000100111100100100111100100111111100100111111100111111111100111100111100100111100100111100111100111100111100111100111101
1000100000000100100100000100000100100100100100100100000000000100100000000100100100100100100000000000100000000000100000101
1100100100111111100111111111111100100111100100100100111111111100111111100111100100100100111100111111111100100111111100101
1000000100100100000000000000100000100000100000100100000100100000000100100000100000100100000000000100000000100100100100001
1000111111100111111100100100100111111111111100100111100100100111111100100100111111100111100111100111111100111100100100101
1000000000100000100000100100000100000000000000000100100000000100000000000100000100000000100000100000100000000000000000101
1000100111111100100111111100111100111100111100111100100111100100111111111111111111111111100100100100111111100111111111111
1000100000100000000100000000100000000100100100000100100100000000100100100000100100000000100100100100000100000000000000001
1011111111111100111111100100100100111111100100111100111111111100100100100111100111111100111111100111111111111111111111111
1000000100000000000000100100000100000100000100000100000100100100100000100100000000000100100100000100100000000100100000101
1100111111100111111111111111100100100100111100111100100100100100100100100111100111100100100111100100111100111100100100111
1000000000000000000100000000000100100100000000000100100100100100000100100000100000100000100100100000100100100100000100101
1000100111111111100111100111111111111111100111111111100100100100111111111100111111100111100100100111100100100100100111111
1000100000000100100100000000000000000100000000000000100100000100000000100100000000000000100000100100000100100000100000101
1011111100111100100111111100111111111100111111100111100111100111111111100100100100100111100111100111100100111100111100111
1000100100100000000000100000000000000100100000000100000100000100000000100000100100100000100100000000000100000000000100101
1000100100111111100100111111111111111111111111100111100100100111100111111111111111100111100111111111100100100100111111101
1000000100000000100100000000100000000000100000100100000000100100000000100000000100100000000100100000000000100100100000001
1000111100111111111111111100111100111111111100100100111111111100100100111100111100100111100100111100100111100111100111111
1000100100100000000100000000000100000000100000100100000000000100100100000100000100000100100000000100100100000000000100101
1000100100100111111100100111100100111111100111100100100111111111111100111100111111111100111100111100111111111100111100101
1000100100000000100000100100100100000000000000100000100100000000100100000000100000000000100100000000000100100100100000001
1000100111111111111111100100100100111100111100100111100111100100100100111111111111100111100111111100111100100111111111101
1000000100100000000100000000100100000100100000100000100100000100000000000100000000100000000000100000000100000000000100001
1000111100100111111111100100111100111111111100111111111100111111100111111100111111111111111100111100111111111111100111101
1000100000000000000000100100100000100000100000100000000100100000100100100000100000000000000000100000000100000000100000001
1100111111111111100100111111100100111100100100100100111100100111100100100111100111100100100111100111100100111111111100111
1000100000100000000100000100000100000100100100100100000000100000000000000000100100000100100100000000100100000000000000101
1000111100111111100111100111111100111100111100100111100111111111111100111111111100111111100100111111111100111100111111101
1000100000100000100100100000000100100000100000000000100100100000000000000100000100000000100000100000100000100100000000101
1100111100100111111100100100111100100111111111100111111100100111100100111100111100111111100100100111111100100111100111101
1000100000100000000100100100100000000000000000100000000100000100000100000100000000100000100100000000100000100100000100101
1111100100100100111100111100111100100111111111100111100100100100111111100100100111100111111111100111100100100111111100111
1000000100000100000000000000100100100000000100100100000100100100000000100100100000100000000100100000100100100100000100101
1111111111111100111111100100100111100100111100111100111111111100111111100100111111100111100100100111111100100100111100111
1000000100000000000100100100100100100100100000100000100100000100000100000000000000100100100000000100000000100000000000001
1011100100100111100100111111100100100111100111100100100100111111100111111111111100111100100100111111111100100100111111111
1000000000100100100100000000000100100100100000000100000000100000100000100000000000100000100100100000000100000100000100101
1100111111111100111111111100111100111100111111100111100111100100111100111111111111111100100111100111111100100111111100101
1000000000000000000000000100000000000100000100100000100100100100100000100100000000000100100100100000000100100100100000001
1111100111100100111111111100100111111100100100111111100100100111111111100111100111100100100100100100111100111100111111101
1000000100000100000000000000100100000100100100000000100000000100100000100000000000100000100000100100000000000000100000101
1011111100100100111111100111111100111111100111111100111111111100100100100111111111111100111100100100111100111100100111111
1000000000100100100000100000000000000000000100100000000000100100100100000000000100100100100000000100100100000100000100001
1000100100111100111100111111100111111111100100111100111111100100111111100100111100100100111100100100100111100100111100111
1000100100100000000000100100000100000000100000000100100000000000100000100100000000000100100000100100000100000100000100101
1011100111111100111111100111100100100111111111111100111100100111111100111111111100111111111100100100111111100111111111101
1000100000100000000100000000100000100100000100000100000000100000000000000000000000100000100000100100100000100100100000001
1111111100111100100111111100111100111100111100111111100111111100111100100111100111100100111111100100100111100100100111111
1000100000100000100100000100000000000100100000100000000000100000000100100100100100100100000100000100000100100000000000001
1000100111111100100100111100111100100100100111111100111111100100100100111100111100111100111111100100111100100100111111101
1000100000100000100100000100000100100000000000000100100000000100100100000000100000100000100100100100100000000100100100001
1000111111100100111100100111111111111100111100111100111100100111111111100100100100100111100100100111111111111100100111111
1000000100000100000000100000100100100100100000100000100000100100000000000100000100100100000000000100000100000000000100101
1100100111100100100100111111100100100100111100100111111111111111111111100111111111100111111100111111100100100111100100101
1000100100000100100100100100100000000100100000000100000100100000000000100000000000000000100100100100000000100100000000101
1011100100111111111111100100111100111111111111100111100100111100111100100111111111100100100100100111111111100100111111101
1000100000000000000000100100000100000100000100000000000000000000100000100000000100000100100000000100000100000100100000001
1100100111111100111111100100111100111100111100111111111100100111111111100100100111100111100111100100100100111100111111111
1000000000100100100100100000100000000000100000000100000100100000100000100100100100000100000100100100100000000100100000001
1111100111100111100100100100111111100100100100111111100111100100111100111100100111111111111100100111111111100111111111101
1000100100000100000100000100100100100100000100100100000000000100100100000100100100100000000000000100100000100100100000001
1000100100100100111111100111100100100111100111100111111111111100100100111111111100111111100100111100100111111100100111111
1000100000100100100000100100100000100100000100000000100000000000000100000000100000000000100100000000100000100100100100101
1111100100111100100100100100100100100111111100111111100100111111111111100111111100111100100100100111100111100100100100111
1000000100100100000100100000000100000100000000000100100100000100000000100000000100000100100100100100100100000000000000101
1000111111100100111111111111100100111100111100111100111111111100111100100111111100111111100111111100100100111111100100101
1000000000000000000100000100100100000000000100100000100000100100100000100100100100000000000100100000000000000100100100101
1111111100111111100100100100111111100100100111100100100100100100111111100100100111100100111100111100100100111100111111101
1000000000000000100000100100000000100100100000100100000100000100000000100000000000000100000100000000100100000000100000001
1100111111100100100111100111100100111111100111100111100100111100100100111100111111100100111111100111100111111100111111101
1000100000100100100100100100100100100100000000100000100100000100100100000000000100000100100000100000100100000000000000101
1000100111111111111100100100111100100111100111100111100100000100111111100100100100111111100111111111111111100100100111111
1000000000100000100000100100000000000000000100000100000111100111100000000111100111100000100000100000000000000100100000101
1100111100111100100100111111111111111100100100111100000000000000000000000000000000111100111100111111100111111100100111111
1000100100100000100100000000100000100100100000000100000000000000000000000000000000000100000000100000000000100100100100001
1011100100100100111111111100100111100111111111111111000110111000001000111011101110000111100100111100111111100111100111111
100010000010010000010010010000000000010000000000000100010010100P001000101010101010000000000100000000100000000000100100001
1011111100100111111100100111111111100100111111111001001100111000001110111010101110011111111111111100111100111100100111111
1000100000000000100100000000000000100000000100000001000000000011100000000000000010000000100000100100000100100100000000101
1011100111111111100111100111100100100111100100111111000000000000000000000000001110000100100111100100100111100100111100111
1000100000000100100000100100000100000100100100100000000000000000000000000100000000000100000000000000100000100000100000101
1100111100100100111100111100111111100100100100111100000111111100111111100100000000000111111100111100111100100111111100101
1000100000100000000100000100000100000000100000100000000100000000100000100100100000100100100000100100100000100000100100001
1000100111100111111111100111100111111100100111111111111111100111111100100111100100111100111100100100111111111111100100101
1000000100000100100000000000000100000100100100000100100000100000100100100000000100100100100000100000000100000000100100101
1100100111111100100111100100100100100100100100111100111100100111100100100111111100100100111111111100111100111100100100111
1000100000000000000000100100100100100000100100100000000000100100000000000100000000100000000100100000100000000100000000101
1011111100111100100111100111111100111111100100100100111111111111100111100111100100111100111100100100111100111111100100101
1000000100100100100000100100000100000000100100000100000100000000100000100100000100000100100000100100100100100000000100001
1000100100100111111100100100111100100100100111111100111100100111111100111111111111111100100111100111100100100100111111101
1000100100000100000000100100100100100100100100100000100000100100000100000000000100000100000000000000100100100100000000101
1011111111111111100100100100100100111111111100100111100100111100111100111111111111100100100111111100100100100111100111101
1000000000000000100100100100000100100000100000000100000100000100000000000000100000100000100000100000000100100100100100001
1011100111111111111100111111100111100111111111100111100100111111111100111111100111111111111111100111100111111100111111111
1000000000100000000100000000100000000100100100100100100100100100000000000000000000100000100100000100000100000100100000001
1011100111100111100100111111100100111100100100100100111100100111111111100111111100100111100111111100100100100100100111101
1000100100000000100000000100000100000000100000000100000000100100100100100000000100000000000100100100100000100100000000101
1111111111100111111111100100100111111100100111111111100100100100100100111111111100111100100100100111111100111100111100111
1000000000000100000000000100100100000100000000100000000100100100000100000100000000000100100100000000000100000000100000001
1100111111100111111111111111100100111100100100100111111111100100111100100111100100111100100111100100111100100111100111111
1000000000100100000000000100000000100100100100000100000000000100100000100000000100100000100100100100000000100000100100001
1100111100111100111100100111111100100100111111100111111100111100100100111100100100100111100100111111111111100111100100101
1000000100100100100000100000100100000100100000100100000000000000100100100100100100100000100100000000000000000100000100101
1011100111100111111100111111100111111100100111100100100100111100100100100111100111100111111100100111111111111111100100111
1000100100000000100000000000100100000000000100000100100100000100100100100000000000100100000000100100100100100000000000001
1011111100100111100100111111100111111100100111100100100111111100111111100111111111111100111100111100100100111100111100101
1000000000100100100100000100100000000000100100000000100000100000000100000100000000100000100000100100000100100100100100101
1011111100100100111100111100100111111111111111100100111100111100111111111111100100111111111100100100111100100100100111101
1000000100100100000000000000000000000000100000000100100100100100100000000000100100000000000100100000100100000100000000101
1011100100111111111100111100111100111111111111100111100100100111100100100100100100100100111100111100100111100100100111111
1000000000000100000100100000100100000000100100000100000000000000100100100100000100100100100000000000000100000000100000101
1000100111100100100111100111100111111111100111100111100111100111111111111100111111111100111100100100111100111100100111101
1000100100000100100000100100000000000100000100000100000100100000100000000000000100000000100000100100100100000100100000001
1100111111111100111100100100111100100111100111111100100100111111111100111111111111111100111100111100100100100100111111101
1000100100000000100000000100100100100000000100000100100100100000000000000000100100000100000000000100000100100100100000101
1011100111111100100111100100100100111100100111100100111100100111100100100111100111100111111100100111111111111100100100111
1000100100000100100100000000100100000100100100100000100100000000100100100000000000000100000000100000000100000000100100101
1000100111100100111111100100100100100111100100111111100111111111111100111111111111100100111111111100111111111111100111101
1000100100100000000000100100100000100000100100000000000000100000100000100100000100100100100000100000000100000100000000001
1000100100111100111111111100111100111100111100100100111100111100100111100111100100111111100111100111100100111100111111101
1000000000100000100100100100000100100100000000100100100000100000000100100000000000000000100100000100000000000100000100101
1000111111111111100100100111100111100100100100111111111111111100100100100111100111111100100100100111100111100100111100111
1000100100000000100000000100000100000000100100000000100100000000100000100000100100000000100100100100000000100100000100001
1000100100100111100100100111111100111100111111111100100111111111100100111100111100111111100100111100100111111100111100111
1000000100100000100100100000100100000100000000000100100000000000100100100000100000000000100100000100100000100000100000001
1111111100111111100100100111100111100111100111111111111100100111100100100111100111111111100111100111111111100100111111111
1000100000000100100100100000100000100100000000100100000100100000000100000100100100100000000000100100000000100100000100101
1100100111111100111100111100100111100111111100100111100100111111111100100100111100100111100100111100111100111100100100101
1000000000100100000000000100100000100000000100100000100000100100100000100000100000000100000100100000000100100000100100001
1011111111100100111111111100100111100111100111100111111111100100100100100100111100111100100111111100111111111111100100111
1000000000100100000100000000100000000000100000000000100000100000100100100100000000100000100000000100000000100000100000101
1111111100100100111100100100111100111111111111100111100111100100111111100111111111100111111100100100100100111100100100111
1000000000000100100000100100000000000000100000000000100000000100000000000000000000100100000100100100100100100100000100101
1111100100111111111100100111100100100111111111100100111111111111100100111111100111100100111111100100111111100100111111111
1000100100100000000000100000100100100000100000100100100100100100100100100100000100100000100000000000000100000000100000001
1100100100111111100111111111100111111111100111111100100100100100100111100111100100111100111111100100111111111111111111111
1000000100000100000000100000100000000000000000000100000000100100100100100000100100100100000100100100000000000100000000001
1011100111100100100111100100100111100100111100100100111111100100111100111100100100100100111100100111111100111100111111111
1000000000100000100000100100000000100100000100100100100000000100000000000100100000000100100100000100000100000100100000101
1000111111111100100111100111100111100100111100100111100111111100111100111100100100111111100100111111100111111100100111101
1000100100000100100100000100000100000100100000100100000000000000000100100000000100100100100000000100000000000100000100001
1000100100111111100111100111100111111111111100111111100100111111111111100100111100100100111111111100111111100100100100111
1000000100000000000000100100000100000000100100000000100100000000000100100100100000000100100100000100100000100000100100101
1011111111111100111100100100111100111100100111111100100111111111111100111100111111100100100100111100111100111100111111101
1000100000000000000100100100100100100000000000000000000100100000000000100100100000000100000000100100100000100000000000001
1000100111111100111111100111100111111111111111111111100100111111111100100111100111111100111100100111100100100100111111101
1000100000100000100000100100000100100100000000100000100100100100100000000000100000000100100100000000100100000100000000101
1100100100111111100111100111100100100111100111100100111100100100100111111111100111111100100111100100111100111100111111111
1000100100000100100000100000000100000000000100000100100000100100100000000000000000100000100100100100100000100100000000101
1100100111111100100111111100111111111100111100111111100111100100111100100111100100100111100100100111111100100111100111111
1000100100000100000100000000000100000000000100100100100000000000000000100000100100000000000100100000100000000000100000101
1011100111100111100111100100100111100111111100100100111100100111111111100111111100111100100100111111100100111100100111101
1000100100000000000000100100100000100000000100000000000000100100000100100100100000000100100000000000000100100000100000101
1100111111111111100100100100100100111100111111100100111100111100100100100100111111111100111100100111100100111100111100111
1000000100100000100100000100100100000100000100100100100000100000100100000000000000000100100000100100000100100100100100001
1011100100111100100111111111111100111100111100100111111100100111111111111111100100111111111100100111100111100100100111101
1000100100000000100100000100000000100100000000100100100000000100000100000000000100100000000100100000100100000100100000001
1000111111100111111100111111100111100100100100111100111100111111100111100111100111100111111111111111100111100111111100111
1000100000000100000000000000100000000000100100100000000000100000000000100100100100000000100000000100100000000000100100001
1011111100111100111111100111111100100111100111100111111100111111100111111100111111111100111111100100111100111111100100101
1000100000000100000000100100100100100000100100100000100100100000000000000100000000100000000100000000100100000100100000101
1000100111100111100111100100100111100111100100111111100100100100111100111100111100111100111111111100100111111100100111111
1000000100000100100000100000100100000100100100000000000100100100000100000000000100100100000000000100000000100000000000001
1111111100100100111111111100100100111100100111100111100100100111100100111111100111100111100100100100100100111111100111111
1000100000100000000100000000100000100000100000000100000000000100000100100000100000000000100100100000100100000100100000101
1100111111100100111100111100100100100100111100111111100100100111100111100111111100111100111100100111100111100100100100111
1000000000100100000100000100100100000100100100100100000100100000100100000000100000000100000000100000100100100100100100101
1011100111100111100100111111100111111100100100100100100111111100111111100111100111111111100111111111111100100100100100101
1000100100000100100000000000000100000100100100100100100100100000100100000100000100000100000000000100000000100000100100001
1000100111111100100111100100111100100111100111100111111100111111100111100100111111100111111111111100100100111100111111101
1000100000000000000000100100000100100000000000000000100000100100000000100100100000000100100000100100100100000100000100001
1000100111100100111111111111100111111100111100100111111100100111100111100100111111100100100111100111111111100111100111101
1000000000100100100100100000100000000100000100100000100100100100000000000100100100100000000100100100000000000000000000101
1000111100100111100100111100111111100100111100100111100100100100111111100100100100100100111100100111111111100100111111111
1000100000100100000000000000100100000100000100100000100000100100100000000100100000000100100000100000000100100100100100001
1011111100100111111111100111100100111111100111100100100111100100111100111100100100111100100111100111100100111111100100111
1000000000100000000100000000000000000000100000100100000000000000100000000000000100100000000000000100000100000000000000101
1111111111111111111111111111111111111111111111111111111111111111111111111111111111111111111111111111111111111111111111111
